7 7
2 4 0 0 0 0 6
0 0 0 3 1 5 7
0 0 0 0 0 0 0
0 0 0 0 0 0 0
0 0 0 3 0 0 0
2 4 6 1 0 5 0
7 0 0 0 0 0 0