7 7
5 0 0 3 0 0 0
7 0 0 0 0 2 3
4 0 0 2 0 0 0
0 0 0 6 0 7 0
0 0 0 0 0 0 0
0 0 1 1 5 0 0
4 0 0 0 0 0 6