6 6
6 4 0 0 0 0
0 0 0 0 0 4
3 0 3 7 0 6
7 0 0 0 2 2
0 0 0 0 0 5
5 1 0 0 0 1