6 6
4 0 0 0 0 0
0 0 0 3 3 0
0 5 0 0 7 0
0 0 2 0 2 4
7 0 6 0 0 6
5 0 1 0 0 1