5 5
5 1 2 0 3
0 1 0 0 4
0 0 0 0 0
5 2 3 0 0
4 0 0 0 0