7 7
5 0 0 0 2 6 4
6 0 0 3 1 0 0
0 0 0 0 0 0 0
0 0 0 0 0 0 0
0 5 0 3 0 0 0
0 2 0 1 0 0 0
0 0 0 0 0 0 4