7 7
2 5 3 0 0 0 0
0 0 4 0 0 0 0
0 0 0 0 6 0 0
0 0 0 3 0 0 0
0 0 0 1 0 4 0
0 0 0 0 0 0 0
2 5 6 0 0 0 1