7 7
8 3 6 0 0 0 5
0 0 0 5 2 0 2
0 0 0 7 0 0 0
0 3 6 1 1 8 0
0 0 0 0 0 0 0
0 0 0 0 0 0 0
7 4 0 0 0 0 4