7 7
4 2 1 6 5 0 3
0 0 0 0 4 0 0
0 0 0 0 0 0 0
0 0 0 0 0 0 0
0 2 1 0 0 0 0
0 6 0 0 0 0 0
0 0 0 0 0 5 3