5 5
2 5 0 0 3
0 1 4 0 0
0 0 0 0 0
2 1 0 0 0
4 0 0 5 3