5 5
2 5 4 0 0
0 0 0 3 0
0 0 0 1 0
2 0 0 0 0
5 0 3 1 4